R 600 500

NO ./textures/texture_bricks.xpm
SO ./textures/texture_metal.xpm
EA ./textures/texture_wood.xpm
WE ./textures/texture_stone.xpm
S ./textures/end.xpm

F 200,100,0
C 0,100,200

    111111111111111111111111111111
    112111111111000000011110000001
    100011110011000S00011111110001
    100011100011000000000000011111
111110111000000000000000000001
100000000111000000011111111001
100000002111000000011110000001
100111111111100111000110000001
10011    111100111110110011111
100111111111100000000110011111  1
100000011000000000000110000001
100000000000000000000110000001
111111000011100000000110000001
11111111001 100000000110000001
10011111001 100000000111111011
10000000001 111110111000011011111
11000000001 100000000011000011
 1111111111 1111111111111111111
